1111111111111111111111111111111111111111111111111111111111111111111111111111111111111111111111111111
10CC0CCCC000000C000110CC0CCCC000000C000110CC0CCCC000000C000110CC0CCCC000000C000110CC0CCCC000000C0001
10C0110C00000000C00110C0110C00000000C00110C0110C0000000PC00110C0110C00000000C00CC0C0110C00000000C001
10C0000C0000C000000110C0000C0000C000000110C0000C0000C000000110C0000C0000C000000110C0000C0000C0000001
10000EC0C0000000C00110000CC0C0000000C00110000CC0C0000000C00110000CC0C0000000C00110000CCC0C0000000C01
10000EC0C0000000C00CC0000CC0C0000000C00CC0000CC0C0000000C00CC0000CC0C0000000C00110000CCC0C0000000C01
10000EC0C0M00000C00110000CC0C0000000C00110000CC0C0000000C00110000CC0C0000000C00110000CCC0C0000000C01
10000EC0C0000000C00110000CC0C0000000C00110000CC0C0000000C00110000CC0C0000000C00110000CCC0C0000000C01
10000EC0C0000000C00110000CC0C0000000C00110000CC0C0000000C00110000CC0C0000000C00110000CCC0C0000000C01
10000EC0C0000000C00110000CC0C0000000C00110000CC0C0000000C00110000CC0C0000000C00110000CCC0C0000000C01
10000EC0C0000000C00110000CC0C0000000C00110000CC0C0000000C00110000CC0C0000000C00110000CCC0C0000000C01
10000EC0C0000000C00110000CC0C0000000C00110000CC0C0000000C00110000CC0C0000000C00110000CCC0C0000000C01
1111111111111111111111111111111CCCC1CC1111111111111111111111110CCCCCCCCCCC11111111111111111111111111
11111111111111111111111111111MCMCMCMCMCM111111111111111111111111111111111111111111111111111111111111
10CC0CCCC000000C000110CC0CCCC000000C000110CC0CCCC000000C000110CC0CCCC000000C000110CC0CCCC000000C0001
10C0110C00000000C00110C0110C00000000C00110C0110C0000000PC00110C0110C00000000C00CC0C0110C00000000C001
10C0000C0000C000000110C0000C0000C000000110C0000C0000C000000110C0000C0000C000000110C0000C0000C0000001
10000EC0C0000000C00110000CC0C0000000C00110000CC0C0000000C00110000CC0C0000000C00110000CCC0C0000000C01
10000EC0C0000000C00CC0000CC0C0000000C00CC0000CC0C0000000C00CC0000CC0C0000000C00110000CCC0C0000000C01
10000EC0C0M00000C00110000CC0C0000000C00110000CC0C0000000C00110000CC0C0000000C00110000CCC0C0000000C01
10000EC0C0000000C00110000CC0C0000000C00110000CC0C0000000C00110000CC0C0000000C00110000CCC0C0000000C01
10000EC0C0000000C00110000CC0C0000000C00110000CC0C0000000C00110000CC0C0000000C00110000CCC0C0000000C01
10000EC0C0000000C00110000CC0C0000000C00110000CC0C0000000C00110000CC0C0000000C00110000CCC0C0000000C01
10000EC0C0000000C00110000CC0C0000000C00110000CC0C0000000C00110000CC0C0000000C00110000CCC0C0000000C01
10000EC0C0000000C00110000CC0C0000000C00110000CC0C0000000C00110000CC0C0000000C00110000CCC0C0000000C01
1111111111111111111111111111111111111111111111111111111111111111111111111111111111111111111111111111
