1111111111111
100C000PP00C1
1P0011E00C001
1111111111111