1111111111111
100CC0CC0CM01
1P0011E0M1111
1111111111111